11111111111111111111111111
11...........c..........11
1..11111111111111111....11
1...............c........1
1..M.....................1
1.....1111111111111111...1
1............1........M..1
1.........1111...........1
1..c.....111111111111111.1
1...................1111.1
1...1....M............c..1
1...1....................1
1...1..........P.........1
1...1.........11111......1
1......c.................1
1........1......c........1
1.....11111111.......111.1
1....1...................1
1.1111.c....M..........1.1
11111111111111111111111111
