f000......
...0......
0000......
00........
.00.......
..0.......
.000......
.s00......
..........
..........