f.....00..
0..00000..
0000...00.
........0.
......000.
......0...
......0...
.s00000...
..........
..........