0000.000..
f0.000.00.
........00
........00
.......00.
.......0..
.......0..
.......s..
..........
..........