f.........
0.........
0.........
0000......
...00.....
....000000
.........0
.........0
........00
........s.