f00000...s
.....00..0
......0.00
......0.0.
......000.
..........
..........
..........
..........
..........