f0.00000..
.000...0..
.......0..
.....000..
.....s....
..........
..........
..........
..........
..........