f0000000..
.......000
.........0
........00
.......00.
.......s..
..........
..........
..........
..........