s..0000...
0000..0...
0.........
0.0000.000
000..000.0
..00.....0
.00000...0
.0...00..0
.0....00.0
.......0.f