f00..00000
000000...0
.........s
..........
..........
..........
..........
..........
..........
..........