f.........
0...00000.
00000...s.
...00.....
..........
..........
..........
..........
..........
..........