0000......
f0.00.....
....000000
........00
.......00.
.......s0.
..........
..........
..........
..........