0f........
00........
0.........
00........
.0........
00........
0.........
00........
00........
s.........