f0000.....
....00....
.....000..
.......0..
......00..
.....00...
.....0....
.....0....
.....000..
.....0s...