00000.0000
f0..000..0
.........s
..........
..........
..........
..........
..........
..........
..........