f0........
.00.......
..0.......
..00......
...0.0s...
...0000...
....00....
..........
..........
..........