f00.......
000.......
00........
.0........
.000......
...0......
...000....
...0.00...
...0..0...
...000s...