f.........
0.........
00........
.000....s.
...0...00.
...0...00.
...0000.00
......0..0
......0000
......00..