f0........
.0........
.00.......
..0000....
.....00...
....000...
.0000.....
.s........
..........
..........