f000......
...00...s.
....00..00
.....00000
..........
..........
..........
..........
..........
..........