f00.......
..0....0s.
..0...000.
..0...0...
.00.000...
.0000.....
..........
..........
..........
..........