f.........
00........
.0........
.00.......
..0000....
.....0....
.....0....
.....00...
.....0s...
..........