f00000000.
........0.
......000.
.....00...
000000....
0.........
00........
.s........
..........
..........