f.........
0.........
0.........
0.........
0.........
00.......s
.0.......0
.0.......0
.0..000000
.0000...00