f.........
000.......
.00.......
00........
0.........
0.........
0.........
0.........
00s.......
..........