f0........
.0........
00........
0.000000..
000.00.0..
.00....0s.
..........
..........
..........
..........