f.........
000.......
..0.......
000.0s....
0...00....
0...00....
00000.....
..........
..........
..........