f.........
0.........
0....s....
0....0....
0.0000....
000.00....
..........
..........
..........
..........