f000......
...0......
..00......
..00......
...0......
...0......
...0......
.s00......
..........
..........