f00.......
..00......
...0......
...0......
...00.....
....00....
.00000....
.s........
..........
..........