f000......
...0......
...0......
...0......
...0......
..00......
s.0.......
0000......
.000......
..........