f0000000..
.......0..
.......00.
........00
........0s
..........
..........
..........
..........
..........