f.........
0.........
0.000.....
000.00.00s
.....000..
..........
..........
..........
..........
..........