f.0000000.
000....00.
.......0..
.......0..
.......s..
..........
..........
..........
..........
..........