f00000....
.....000..
.......0..
.......000
.........0
.........0
........s0
..........
..........
..........