0000000...
f0....00..
.......00.
........0.
........00
.........0
.........0
........00
........s.
..........