f.........
0.........
0.........
0.........
00000.....
....00....
s00000....
...00.....
..........
..........