f.000.0000
000.000..0
.00......0
.........0
........00
........0.
........s.
..........
..........
..........