f.........
000.......
..0.......
..0.......
..0.......
.00.......
.0........
00........
0.........
00000000s.