f.........
0.........
0000......
00.0....0s
...0000.0.
......000.
..........
..........
..........
..........