f0000.....
....0.....
....0.....
....0.....
....0.....
....0.....
....0.....
....00....
.....0....
.....000s.