f00.......
.00.......
00........
0.........
000000....
.....0s...
..........
..........
..........
..........