f0000.....
....00....
.....0....
.....000..
......00..
......000.
........0.
........00
.......s.0
.......000