f0........
00........
000.......
..0.......
000.......
0.........
0.......0s
000...0000
..00..0...
...0000...