f..00.....
0..000....
0000.0....
....00....
....s.....
..........
..........
..........
..........
..........