f00.......
..000.....
....0.....
....00....
.....000..
......00..
.....00...
.....s....
..........
..........