f0........
.0........
.00.......
..0.......
..0.......
..0.......
.00.......
.0........
00.0s.....
00000.....