f...0000..
00000..0..
.......0..
.......0..
.....000..
.....0....
.....0....
.....s....
..........
..........